[Template]
TemplateVersion = 1.0
TableID = Point-1.0  # HistoryPoint table
TemplateName = JF_getHP
Intent = Retrieve                               # Can have multiple intents, comma-separated
OutputHeader = true
Format = Csv
Output = CompleteSuccessful

[Calculated]
ReportStart(Timestamp) = "2014-05-01T00:00:00.000Z"
ReportEnd(Timestamp) =  "2014-05-01T00:05:00.000Z"

[Output]

##### Base HP Table

UnitId =  Input.UnitId
DriverId =  Input.DriverId
Time =  Input.Time
Tag =  Input.Tag
Vin =  Input.Vin
Lat =  Input.Lat
Lon =  Input.Lon
Address =  Input.Address
GpsQuality =  Input.GpsQuality
Heading =  Input.Heading
SerialNumber =  Input.SerialNumber
EventIndex =  Input.EventIndex
EventCode =  Input.EventCode
FirmwareVersion =  Input.FirmwareVersion
Hdop =  Input.Hdop
Vdop =  Input.Vdop
Pdop =  Input.Pdop
NumSatellites =  Input.NumSatellites
UnitType =  Input.UnitType
OdometerDelta =  Input.OdometerDelta
EngineTimeDelta =  Input.EngineTimeDelta

##### DIAG Table

AbsEvent =  Input.AbsEvent
AbsIndicator =  Input.AbsIndicator
AcceleratorPosition =  Input.AcceleratorPosition
AccelViolationsCount =  Input.AccelViolationsCount
AdaptiveCruiseEngaged =  Input.AdaptiveCruiseEngaged
AirbagDeployed =  Input.AirbagDeployed
AirbagLight =  Input.AirbagLight
AirBrakeEngaged =  Input.AirBrakeEngaged
Altitude =  Input.Altitude
AmbientAirTemp =  Input.AmbientAirTemp
BrakeIndicator =  Input.BrakeIndicator
BrakePedalSwitch =  Input.BrakePedalSwitch
CabinTemperature =  Input.CabinTemperature
Coasting =  Input.Coasting
CoastingTime =  Input.CoastingTime
CollisionDeceleration =  Input.CollisionDeceleration
CruiseControlActive =  Input.CruiseControlActive
CruiseControlSetSpeed =  Input.CruiseControlSetSpeed
CurrentGear =  Input.CurrentGear
DecelViolationsCount =  Input.DecelViolationsCount
EngineOverspeed =  Input.EngineOverspeed
EngineSpeed =  Input.EngineSpeed
EngineTorque =  Input.EngineTorque
FuelRate =  Input.FuelRate
FuelRemaining =  Input.FuelRemaining
HarshAcceleration =  Input.HarshAcceleration
HarshBraking =  Input.HarshBraking
HighEngineTemp =  Input.HighEngineTemp
HighWindSpeed =  Input.HighWindSpeed
LoadPercent =  Input.LoadPercent
LostExternalPower =  Input.LostExternalPower
LowBrakeFluid =  Input.LowBrakeFluid
LowEngineOilPressure =  Input.LowEngineOilPressure
LowFuelLevel =  Input.LowFuelLevel
LowTirePressure =  Input.LowTirePressure
MaxAccel =  Input.MaxAccel
MaxDecel =  Input.MaxDecel
MilStatus =  Input.MilStatus
OBDII_DTC =  Input.OBDII_DTC
Panic =  Input.Panic
Raining =  Input.Raining
SeatBeltFastened =  Input.SeatBeltFastened
SeatbeltIndicator =  Input.SeatbeltIndicator
SimCardRemoved =  Input.SimCardRemoved
Speed =  Input.Speed
SpeedingOverMax =  Input.SpeedingOverMax
SpinOutEvent =  Input.SpinOutEvent
StabilityControlEngaged =  Input.StabilityControlEngaged
TotalFuelUsed =  Input.TotalFuelUsed
TotalHighGearTime =  Input.TotalHighGearTime
TractionControlEngaged =  Input.TractionControlEngaged
TrailerCoupled =  Input.TrailerCoupled
TripCruiseControlTime =  Input.TripCruiseControlTime
TripDistance =  Input.TripDistance
TripDrivingWithoutSeatbeltTime =  Input.TripDrivingWithoutSeatbeltTime
TripDuration =  Input.TripDuration
TripFuelUsed =  Input.TripFuelUsed
TripFuelUsed2 =  Input.TripFuelUsed2
TripFullThrottleTime =  Input.TripFullThrottleTime
TripHighGearTime =  Input.TripHighGearTime
TripHighRpmTime =  Input.TripHighRpmTime
TripMaxSpeed =  Input.TripMaxSpeed
TripOptimalRpmTime =  Input.TripOptimalRpmTime
TripSpeedingTime =  Input.TripSpeedingTime
WindSpeedAlarmCount =  Input.WindSpeedAlarmCount
WindSpeedPreAlarmCount =  Input.WindSpeedPreAlarmCount
YawRate =  Input.YawRate


[Filter]
Time = Between(ReportStart,ReportEnd)